%%%%%%%%%%%%%%%%%%%%%%%%%%%%%%%%%%%%%%%%%%%%%%%%%%%%%%%%%%%%%%%%%%%%%%%%%%%%%%%%%
%P......%.......%...%.%.....%...%...%...%.............%.%...%.........%.....%...%
%...%.%%%.%.%%%.%.%.%.%.%.%%%.%.%.%.%.%%%.%%%.%%.%%%%.%.%.%.%.%.%%%%%.%.%%%.%%%.%
%...%.....%.%.%...%.%...%...%.%.%.%.%.%...%.%.%.....%.%...%...%.....%...%.%.....%
%%%.%%%%.%%.%.%..%%.%%.%%.%.%%%.%.%.%.%.%%%.%.%%%%%.%.%.%%%%%.%...%.%.%%%.%.%.%.%
%...%.%.....%.....%.....%.%...%...%.%.%.....%.....%.%.%.....%...%.......%...%.%.%
%...%.%.%.%...%.%.%.....%.%.%.%%%.%.%.%%%%%.%%%%%.%.%.%%%%%.%.%.%.%%%.%.%%%.%.%%%
%.%...%.%.%...%.%.%.....%...%.....%.%.......%.....%.%.....%...%.%.....%...%.....%
%.%%%.%.%%%.%.%%%.%.%..%%.%%%.%%%.%.%%.%%%%.%.%%%%%.%.....%.%...%%.%%.%%%.%.%%%.%
%.%.......%.%.%...%.%...%.%.....%.%.....%.....%...........%.%.......%.%...%.%...%
%.%.%%%%%.%.%.%.%%%.%.%.%%%.%%%.%.%%....%.%%%%%.%%%.%%%.%%%.%.%%%%%.%%%.%%%.%.%.%
%...%...%...%.%.....%.%.....%...........%.%...%.%.%...%.....%.....%.....%...%.%.%
%.%.%%%.%%%%%.%.%.%%%.%.%.%%%.%%%%%%%.%%%.%.%%%.%.%%%.%.%%.%%%%........%%.%%%.%.%
%.%.........%.%.%...%.%...%.%.%.......%...%.......%.%...%.........%.....%...%.%.%
%.%.%%%.%%%%%.%.%%%.%.%%%%%.%.%.%%%%%%%%%.%%.%%%%.%.%%%%%.%%.%%%%%%%.%%.%%%.%.%%%
%...%...%.....%...%...%.......%.........%.......%...%...%.%...%...........%.%...%
%%%.%.%%%.%%%%%.%%%%%%%.%%%.%....%%.%%%.%%%%%.%.%%%.%.%.......%.%.%%%%.%%%%.%%%.%
%.......%.%...........%.%...%.........%.........%.%...%...%.%.%.%...%.....%.%...%
%.%%%%%%%.%.%%%%%.%%%.%.%%%.%.%%%%%%%.%%%%%%%%%%%.%%%.%%%.%.%.%.%%%.%.%%%.%.%.%%%
%.........%.....%...%.%...%.%...%...%...%...%.....%.....%...%...%.%.....%.%.%...%
%%%%%.%.%%%%%...%%%.%.%%%.%.%%%.%%%.....%.%.%%%.%.%.%%%.%.%%%%%%%.%%%.%%%.%.%.%.%
%.....%...%...%...%.%.%...%...%...........%.....%...%...%.........%...%...%.%.%.%
%.%%%%%%%.%.%.%.%.%.%.%.%%%.%.%%%%%.%.%%%%%%%.%%%%%%%.%%%%%%%.%%%.%%%.%.%%%.%.%.%
%.......%.%.%...%.%.%.%.%...%.....%.%.......%.%...%...%...%.....%...%.%...%.%.%.%
%%%.%%.%%.%.%%%%%.%.%%%.%.%.%..%%.%.%%%%.%%.%%%.%.%%%%%.%.%.%.%.%%%.%.%%%.%.%%%.%
%.........%...%...%...%.%.%.%...%.%.......%.....%.......%.%.%.%...%.%...%.%.....%
%.%%%%....%%%.%.%%%.%.%.%%%.%%%.%.%.%%%.%.%.%.%%%.%.%%%%%.%.%.....%.%.%.%.%%%%%.%
%...%.....%...%.%...%.......%...%...%...%.%.%...%.%.%.....%.%.....%.%.%.%.....%.%
%.%.%%%.%%%.%%%.%%.%%%%%%%%%%.%%%%%%%.%%%.%.%%%.%.%.%%%.%.%.%.%%%%%.%%%.%%%%%.%.%
%.%...........%.......................%...%.....%.......%...%...............%..*%
%%%%%%%%%%%%%%%%%%%%%%%%%%%%%%%%%%%%%%%%%%%%%%%%%%%%%%%%%%%%%%%%%%%%%%%%%%%%%%%%%