%%%%%%%%%%%%%%%%%%%%%%%%%%%%%%%%%%%%%%%%%%%%%%%%%%%%%%%%%%%%%
%.........%.%...........%.....%...........%...........%....*%
%.%%%%.%%.%.%.%%%%%.%%%%%.%%%.%.%%%%.%%.%%%.%%.%%.%%%.%.%.%.%
%.%.....%...%.....%.......%...%.......%.....%...%.%.%...%.%.%
%.%.%%%.%.%%%%.%%.%%%%%%%%%.%%%%%.%%%.%.%%%.%.%.%.%.%%%%%.%.%
%.%...%...%.......%.......%.......%...%...%.%.%.%.....%...%.%
%.%.%%%.%%%.%%%.%%%.%.%%%.%%%%.%%.%.%%%.%.%%%.%.%%%.%%%.%%%.%
%...%.....%.....%...%.%.........%.%.%...%.....%...%.%...%.%.%
%.%%%.%%%.%%%%%.%%%%%.%.%%%.%%%.%%%%%.%%%%%%.%%%%.%%%.%%%.%.%
%.....%.......%.........%.%.%.........%...%.....%.....%...%.%
%.%%%%%.%%%%%.%%%%%.%%%.%.%.%.%%%%%%%%%.%.%.%%%.%%%.%%%.%%%.%
%.%...%.%...%.........%.%...%.%.....%...%.%.%...........%...%
%.%.%%%.%.%%%.%%%%%.%.%.%%%%%.%.%.%%%.%.%.%%%.%%%%%.%%%%%.%%%
%...%...%.%.......%.%.%...%...%.%...%.%.%.....%.....%...%.%.%
%.%%%.%%%.%.%.%%%.%%%.%%%.%.%%%.%%%.%.%.%%%%%%%%%.%%%.%.%.%.%
%.%...%...%.%...%...%.%...%.%.....%...%...%.....%.%...%...%.%
%...%%%.%.%.%.%.%.%.%.%.%%%.%.%%%%%%%.%%%.%.%%%.%.%.%%%%%%%.%
%.%...%.%...%.%...%...%.%.................%.%...%.%.%.......%
%.%%%.%%%.%%%.%%%.%.%%%.%.%%%.%.%%%%%%.%%%%.%.%%%%%.%.%.%%%.%
%...%.........%...%.%...%.%...%.........%...%.%.....%.%.%...%
%%%.%%%.%.%%%%%.%%%%%.%%%%%.%%%.%%%%%%%.%.%%%.%.%%%%%%%.%.%%%
%P....%.......%.............%.........%.....%...........%...%
%%%%%%%%%%%%%%%%%%%%%%%%%%%%%%%%%%%%%%%%%%%%%%%%%%%%%%%%%%%%%