%%%%%%%%%%%%%%%%%%%%%%%%%%%%%%%%%%%%%
%.....................%P............%
%.....................%.............%
%.....................%.............%
%.....................%.............%
%.....................%.............%
%.....................%%%%%%........%
%..........................%........%
%..........................%........%
%..........................%........%
%..........................%........%
%..........................%........%
%........%%%%%%%%%%%%...............%
%........%..........................%
%........%..........................%
%........%..........................%
%........%..........................%
%........%..........................%
%.......*%..........................%
%%%%%%%%%%%%%%%%%%%%%%%%%%%%%%%%%%%%%